a=e;yan
ai=e;yi
an=han
ao=niu
ba=pa
bai=bo
bang=beng;pang;peng
bao=bo;bu;pao;pu
bei=bi
beng=bang
bi=bei;mi;pi
bian=pian
biao=piao
bin=bing;fen
bing=bin;ping
bo=bai;bao;bu;po
bu=bao;bo;pu
ca=cha
can=cen;shen
cang=zang
cen=can;shen
ceng=zeng
cha=ca;chai;ci;sha;zha
chai=cha;ci
chan=dan;shan;tan
chang=zhang
chao=chuo;zhao
che=chi;ju
chen=cheng;qin;shen
cheng=chen;dang;deng;sheng
chi=che;shi
chong=shuang;yong;zhong
chou=dao;niu;qiu;xiu
chu=xu
chuai=chuo
chuan=zhuan
chuang=zhuang
chuo=chao;chuai
ci=cha;chai;si;zi
cong=zong
cu=zu
cuan=zan
cuo=zuo
da=dai;ta
dai=da;tai
dan=chan;shan;shi;tan
dang=cheng
dao=chou;tao
de=dei;di
dei=de
deng=cheng
di=de;ti;zhai
diao=tiao;yao
die=zha
dong=tong
dou=du
du=dou;duo;she
dun=tun;zhuan
duo=du;tuo
e=a;ai;o;wu
er=nai
fan=pan;po
fei=fu
fen=bin
fo=fu
fou=pi
fu=fei;fo;mi;pu
ga=jia;ka;qie
gai=ge;jie
gan=han
gang=kang;zhuang
ge=gai;ha;he;ka;le;li;lo;luo
gei=ji
geng=jing
gou=ju
gu=gua;hu;jia
gua=gu;wa
guan=lun;wan
gui=hui;jiong;ju;jun;qiu
guo=wo
ha=ge
hai=huan;ke
han=an;gan
hang=heng;keng;xiang;xing
hao=he
he=ge;hao;hu;huo;xia
heng=hang;hng;xing
hng=heng
hong=jiang
hu=gu;he;huo;xu
huan=hai;xun;yuan
hui=gui;kuai;kui;yue
huo=he;hu
ji=gei;jie;qi;xi;zhai
jia=ga;gu;jie;qie
jian=kan;qian;xian
jiang=hong;qiang;xiang
jiao=jue;qiao;qiu;xiao;yao
jie=gai;ji;jia;kai;xie
jin=jing
jing=geng;jin;liang
jiong=gui
ju=che;gou;gui;qie;qu;zui
juan=quan
jue=jiao
jun=gui;qiu;qu;qun;suo;xun;yun
ka=ga;ge;lo;luo;qia
kai=jie
kan=jian
kang=gang
ke=hai;qiao
keng=hang
kuai=hui
kui=hui
la=lao;luo
lang=liang
lao=la;luo
le=ge;lei;liao;yue
lei=le
leng=ling
li=ge;lian;yue
lia=liang
lian=li
liang=jing;lang;lia
liao=le
ling=leng
liu=lu
lo=ge;ka;luo
long=nong;shuang
lou=lu
lu=liu;lou;luo;shuai
lun=guan
luo=ge;ka;la;lao;lo;lu
ma=mo
mai=man;mo
man=mai;wan
mei=mi;mo
mi=bi;fu;mei
miao=miu;mou
mie=nie
miu=miao;mou
mo=ma;mai;mei;mu;wan;wu
mou=miao;miu;mu
mu=mo;mou
na=nan;ne;nuo
nai=er
nan=na
ne=na;ni
ni=ne
nian=zhan
niao=sui
nie=mie
niu=ao;chou
nong=long
nue=yao
nuo=na
o=e
ou=qu
pa=ba
pai=po
pan=fan;pang
pang=bang;pan
pao=bao
peng=bang
pi=bi;fou
pian=bian
piao=biao;po;pu
ping=bing
po=bo;fan;pai;piao;pu
pu=bao;bu;fu;piao;po
qi=ji;si;xi
qia=ka
qian=jian;qie;xi;xian;xun;yan
qiang=jiang
qiao=jiao;ke;que;shao
qie=ga;jia;ju;qian
qin=chen;qing;tan
qing=qin
qiu=chou;gui;jiao;jun;you
qu=ju;jun;ou;xu
quan=juan;xuan
que=qiao
qun=jun
ren=shen
sa=suo
sai=se
san=shen
se=sai;shai
sha=cha;shan;suo;xia
shai=se
shan=chan;dan;sha;zha
shao=qiao;xiao;zhao
she=du;shi;zhe
shei=shui
shen=can;cen;chen;ren;san;shi;xin
sheng=cheng;xing
shi=chi;dan;she;shen;si;xu;zhi
shou=shu
shu=shou;shuo;zhu
shuai=lu
shuang=chong;long
shui=shei;shuo
shuo=shu;shui
si=ci;qi;shi
su=suo;xiu
sui=niao
suo=jun;sa;sha;su
ta=da;tuo
tai=dai
tan=chan;dan;qin
tao=dao
ti=di;xi;yi
tiao=diao
tong=dong
tui=tun
tun=dun;tui
tuo=duo;ta
wa=gua
wan=guan;man;mo
wei=xu;yi;yu
wo=guo
wu=e;mo
xi=ji;qi;qian;ti;xian
xia=he;sha
xian=jian;qian;xi
xiang=hang;jiang
xiao=jiao;shao;xue
xie=jie;xue;ye
xin=shen
xing=hang;heng;sheng;ying
xiu=chou;su
xu=chu;hu;qu;shi;wei;yu
xuan=quan
xue=xiao;xie
xun=huan;jun;qian
ya=zha
yan=a;qian;ye;yin;yuan
yao=diao;jiao;nue;yue
ye=xie;yan
yi=ai;ti;wei
yin=yan
ying=xing
yong=chong;yu
you=qiu
yu=wei;xu;yong;yun
yuan=huan;yan;yun
yue=hui;le;li;yao
yun=jun;yu;yuan
za=zan;ze;zha
zai=zi
zan=cuan;za
zang=cang;zhuang
ze=za;zha;zhai;zuo
zeng=ceng;zong
zha=cha;die;shan;ya;za;ze;zuo
zhai=di;ji;ze;zhi
zhan=nian
zhang=chang
zhao=chao;shao;zhe;zhou;zhua;zhuo
zhe=she;zhao;zhuo
zhi=shi;zhai;zi
zhong=chong
zhou=zhao
zhu=shu;zhuo
zhua=zhao
zhuan=chuan;dun
zhuang=chuang;gang;zang
zhuo=zhao;zhe;zhu;zuo
zi=ci;zai;zhi
zong=cong;zeng
zu=cu
zui=ju
zuo=cuo;ze;zha;zhuo
